11111111111111
10001000000001
10001111000001
10000001000001
10000000000001
11111111111111