11111111111111111111
10000000000000000001
10010000100010001001
10100000000000000101
10000000001000000001
10000000000P00000001
10100000100010000101
10010000000000001001
11111111111111111111
