NO ./textures/redbrick.xpm
SO ./textures/purplestone.xpm
EA ./textures/greystone.xpm
WE ./textures/eagle.xpm
F 255255234
C 243123123

11111111111111111111
10000000000000000001
10000000000000000001
10000000000000000001
10000000001001000001
1000000100000W111001
10000000001001000001
10000000000000000001
11111111111111111111
