NO ./textures/redbrick.xpm
SO ./textures/purplestone.xpm
EA ./textures/greystone.xpm
WE ./textures/bluestone.xpm
F 255255234
C 243123123

11111111111111111111
10000000000000000001
10010000100010001001
10100000000000000101
10000000001000000001
10000000000N00000001
10100000100010000101
10010000000000001001
11111111111111111111
