NO ./textures/redbrick.xpm
SO ./textures/purplestone.xpm
EA ./textures/greystone.xpm
WE ./textures/bluestone.xpm
C 243,123,123
F 255,255,234

11111111111
11000000001
1010000S001
10010000001
10001000001
10001111101
10000000001
11111111111