NO ./textures/redbrick.xpm
SO ./textures/purplestone.xpm
EA ./textures/greystone.xpm
WE ./textures/bluestone.xpm
F 255,255,234
C 243,123,123

11111111111
10000000001
10100000011
1001N000011
10001000001
10001111111
10000000001
11111111111
10000000001
111111111111
1111111111